%%%%%%%%%%%%%%%%%%%%%%%%%%%%%%%%%%%%%
%                    ..............P%
%            %      ..              %
%            %     ..               %
%            %    ..                %
%            %   ..                 %
%            %  ..                  %
%            % ..   %               %
%            %..    %               %
%            %.     %               %
%            %.     %               %
%            %.     %               %
%            %.     %               %
%            %.     %               %
%%%%%%%%%%%%%%.     %%%%%%%%%%%%%%%%%
%            %.                     %
%            %.                     %
%            %.                     %
%   ...........                     %
%  ..                               %
%...                                %
%.                                  %
%%%%%%%%%%%%%%%%%%%%%%%%%%%%%%%%%%%%%
