%%%%%%%%%%%%%%%%%%%%%%
% %%        % %      %
%    %%%%%% % %%%%%% %
%%%%%%.....P  %      %
%    %.%%%%%% %% %%%%%
% %%%%.%.....    %   %
%     ...%%%.%%%   % %
%%%%%%%%%%... %%%%%% %
%..........%%        %
%%%%%%%%%%%%%%%%%%%%%%
